########################################
#......................................#
#......................................#
#......................................#
#......................................#
#......................................#
#......................................#
#......................................#
#......................................#
#......................................#
#......................................#
#......................................#
#......................................#
#......................................#
#......................................#
#......................................#
#......................................#
#......................................#
#......................................#
#......................................#
#.........###########..................#
#.........###########..................#
#^^^^^^^^^#.........#^^^^^^^^..........#
#.........#.........#..................#
#......................................#
#^^^^^^^^^.............................#
#......................................#
#P...........................P.........#
########################################
########################################
