#..............#........#..............#
#..............#........#..............#
#..............#........#..............#
######.........#........#.........######
#....#............................#....#
#....#............................#....#
#....#............................#....#
#....#............................#....#
#....#....^^^^^#........#^^^^^....#....#
#....#.........#........#.........#....#
#....#.........#........#.........#....#
#....#.........#........#.........#....#
#....#.........#........#.........#....#
#....#^^^^.....#^^^^^^^^#.....^^^^#....#
#..............#........#..............#
#..............#........#..............#
#..............#........#..............#
#..............#........#..............#
################^^^^^^^^################
#......................................#
#......................................#
#.............#........................#
#.............#........................#
#....#....######^^^^^^^^######....#....#
#....#.........#........#.........#....#
#....#.........#........#.........#....#
#....#.........#........#.........#....#
#P...#.........#........#.........#...P#
########################################
########################################
