########################################
#......................................#
#......................................#
#......................................#
#......................................#
#......................................#
#......................................#
#......................................#
#......................................#
#......................................#
#......................................#
#......................................#
#......................................#
#......................................#
#......................................#
#......................................#
#......................................#
#......................................#
#......................................#
#......................................#
#......................................#
#......................................#
#...............................#^^^^^^#
#.^^^^^#........................#......#
#......#........................#......#
#......#........................#......#
#......#........................#......#
#...P..#........................#...P..#
########################################
########################################
